NO ./images/north.xpm
SO ./images/west.xpm
WE ./images/south.xpm
EA ./images/east.xpm

F 0,120,0
C 0,0,120

        1111111111111111111111111
       11000001001110000000000001
        1011000001 10000000000001
        1001000001010000000001111
111111  10110001111111111111111 
1111011 11111101 100000010001    
1111011111111111 101010010001
11000000110101011100000010001
10000000000000000000000010001
10000000000000011101010010001
1100000111010101 111011110N0111
11110111 1110101 101111010001
11111111 1111111 111111111111
